8 6
..###..D
S.......
..#....#
....##..
.....##.
